1111111111111111111
11110C0111110C01111
1100000P111E0000011
1000100001000010001
1001000001000001001
1001000000000001001
1000000C000C0000001
1000000100010000001
1100000000000000011
1100000001000000011
1110000000000000111
1111000000000001111
111110010C010011111
1111110011100111111
111111100C001111111
1111111100011111111
1111111110111111111
1111111111111111111