111111111
1C0000011
100000001
110P00001
1000E0011
1C00001C1
111111111