1111111111111
11C0C00111111
110111C00C0E1
11C1110111101
110100C0011C1
1101010101101
10C0C0C0C0C01
1011010101011
1C1100C001011
1011110111C11
1P0C00C111011
11111100C0C11
1111111111111