111111111
1P01111E1
110000001
111C00001
111111111