11111
10C01
11011
10P01
11011
1C0E1
11111
