111111111111111
1110011C1100111
110011000110011
10011C000C11001
101100000001101
111C0000000C111
110000000100011
1P00001000000C1
110000000000011
111C0000100C111
101100000001101
10011C000C11001
110011000110011
1110011E1100111
111111111111111