1111111
111P111
1100011
110C011
1100011
1C0E0C1
1111111