111111111
1S0000001
1P00000C1
1C00E00S1
111111111