111111111
1C0000011
100000001
110P00001
1000E0001
1C0000101
111111111