1111111111111111111
1000001000001001001
1000001100001000C01
101C000001P00000011
10000010000110S0001
1000001000001000101
1110111110111110111
1000011010001000S01
1000001100001001001
10010000C1000000001
10000010000110S0001
1100001000101000111
1110111110111110111
1000101000001000001
1000001000011001001
11000000E0000000001
1001001000011000SC1
1C00001000001010001
1111111111111111111