1111111111111
11C0000111111
110111C0000E1
1101110111101
1101C000C1101
1101011101101
10C100C000C01
1011010111011
1011C000C1011
1011110111011
1P0000C111011
1111110000C11
1111111111111