1111111111111111111111111111111
1SSSSSSSSSSSSSSSSSSSSSSSSSSSSS1
1S000000000000000000000000000S1
1S011101010111010101010101110S1
1S000001000000000000000000010S1
1S010101010101110101010101010S1
1S010000010000000000000000010S1
1S010101010101011101010111010S1
1S000100000100000000000000000S1
1S010101010101010111010101010S1
1S000000000000000000010000000S1
1S010101010101010101010101010S1
1S010000000000000100000100000S1
1S010101011101010101010101010S1
1S000001000000P0C000000001000S1
1S0101010101010S0101010101010S1
1S000000000000C0E000000000010S1
1S010111010101010101010101110S1
1S000000000000000000000000010S1
1S010101110101010101110101010S1
1S000100000000000000000001000S1
1S010101010101010101010101010S1
1S000000000001000000000000000S1
1S010101010101010111010101010S1
1S000000010000000000000000000S1
1S010111010101010101010111010S1
1S010000000100000000010000010S1
1S010101110101011101010101110S1
1S000000000000000000000000000S1
1SSSSSSSSSSSSSSSSSSSSSSSSSSSSS1
1111111111111111111111111111111
