11111
11101
1C001
11PE1
1C001
11101
11111